3,3
3233314313
1111114313
3212224213
3212334213
3212344213
3313343213
3311141113
4444443222
