3,3
1111144122
1322133122
1322133144
1111111111
4422144322
4433122322
2233122444
2211111333
