3,1
3221333313
3221333313
4444444444
3221444413
3221344413
3221334413
3221333413
3221333313
