4,2
3211333333
3223333333
3133144113
3133433343
3233133343
3411432213
3333332333
3344421333
