3,4
2222211111
2111214444
2111214114
2133333334
2222214444
1131111131
1131111131
1133333331

