3,1
1441113322
2144113322
2214413344
2224442211
1133333322
1134411122
1334111441
1344444411
