3,4
2243431142
2223231142
3333131342
2311111142
3331313142
3311313142
2441413122
2221313122
