4,1
3333322222
3333322222
3311111122
3322233322
1122233311
1133322211
1133322211
1133322211
