3,2
2211224442
1111244342
1131111111
2241224422
4441444442
2441424434
2241224444
2211122442
